Emma	Liam
Olivia	Noah
Ava	Oliver
Isabella	Mason
Sophia	Logan
Amelia	Lucas
Mia	Elijah
Charlotte	Ethan
Harper	James
Mila	Aiden
Aria	Carter
Ella	Jackson
Evelyn	Sebastian
Avery	Alexander
Abigail	Michael
Riley	Benjamin
Emily	Jacob
Luna	William
Scarlett	Jack
Chloe	Grayson
Sofia	Owen
Layla	Luke
Lily	Daniel
Ellie	Henry
Madison	Wyatt
Zoey	Jayden
Elizabeth	Gabriel
Grace	Leo
Penelope	Julian
Victoria	Matthew
Nora	David
Aubrey	Jaxon
Camila	Levi
Bella	Mateo
Hannah	Lincoln
Aurora	Samuel
Addison	Asher
Skylar	Muhammad
Stella	John
Savannah	Ryan
Paisley	Isaac
Emilia	Adam
Natalie	Isaiah
Elena	Nathan
Maya	Josiah
Violet	Hunter
Hazel	Caleb
Nova	Joseph
Niamey	Anthony
Eva	Eli
Audrey	Dylan
Lucy	Landon
Brooklyn	Connor
Zoe	Joshua
Hailey	Hudson
Aaliyah	Ezra
Lillian	Andrew
Eleanor	Christian
Alice	Adrian
Kinsley	Greyson
Leah	Thomas
Adeline	Carson
Claire	Jeremiah
Sophie	Christopher
Kennedy	Easton
Sarah	Jaxson
Gabriella	Cameron
Willow	Colton
Eliana	Max
Arya	Nolan
Everly	Aaron
Naomi	Xavier
Peyton	Jordan
Isla	Maverick
Anna	Charlie
Quinn	Cooper
Athena	Brayden
Maria	Elias
Madelyn	Kayden
Gianna	Jace
Cora	Bryson
Ariana	Kai
Brielle	Dominic
Caroline	Austin
Aubree	Roman
Rylee	Theodore
Autumn	Luca
Clara	Ayden
Ruby	Jameson
Adalynn	Nicholas
Valentina	Evan
Julia	Ian
Nevaeh	Parker
Sadie	Sawyer
Ivy	Ezekiel
Delilah	Alex
Serenity	Micah
Mackenzie	Santiago
Piper	Avery
Jade	King
